00010117
fff10113
008000ef
0000006f
ff010113
00112623
00812423
01010413
02c000ef
00c12083
00812403
01010113
00008067
000107b7
00a7a023
0007a783
40f50533
00153513
00008067
fd010113
02112623
02812423
02912223
03212023
01312e23
01412c23
00010537
fff50513
00000a13
00055663
40a00533
00100a13
00410413
00a00493
00900993
00050913
00048593
118000ef
00140413
00a9c863
03050793
0ff7f793
00c0006f
05750793
0ff7f793
fef40fa3
00090513
00048593
0a4000ef
fca044e3
00040793
000a0863
00140413
02d00713
00e78023
00040023
00410793
40f40433
00145593
02058863
00078713
fff40413
008787b3
00b705b3
00074683
0007c603
00c70023
00d78023
00170713
fff78793
feb714e3
00414503
00050c63
00510413
f0dff0ef
00140413
fff44503
fe051ae3
00000513
02c12083
02812403
02412483
02012903
01c12983
01812a03
03010113
00008067
06054063
0605c663
00058613
00050593
fff00513
02060c63
00100693
00b67a63
00c05863
00161613
00169693
feb66ae3
00000513
00c5e663
40c585b3
00d56533
0016d693
00165613
fe0696e3
00008067
00008293
fb5ff0ef
00058513
00028067
40a00533
0005d863
40b005b3
f95ff06f
40b005b3
00008293
f89ff0ef
40a00533
00028067
00008293
0005ca63
00054c63
f79ff0ef
00058513
00028067
40b005b3
fe0558e3
40a00533
f61ff0ef
40b00533
00028067
00000000
00000000
00000000
00000000
00000000
00000000
00000000
00000000
00000000
00000000
00000000
00000000
00000000
00000000
00000000
00000000
00000000
00000000
00000000
00000000
00000000
00000000
00000000
00000000
00000000
00000000
00000000
00000000
0000ffff
00000010
