00010117
fd010113
008000ef
0000006f
ff010113
00112623
00812423
01010413
044000ef
018000ef
00000013
00c12083
00812403
01010113
00008067
ff010113
00812623
01010413
0000006f
000107b7
fea7ae23
ffc7a783
40a78533
00153513
00008067
fe010113
00112e23
00812c23
00912a23
01212823
00410493
06c00413
00710913
00148493
00a00593
00040513
0d4000ef
03050513
fea48fa3
00a00593
00040513
078000ef
00050413
fd249ce3
000103a3
00710793
00410713
00078593
00074683
fff7c603
00c70023
fed78fa3
00170713
fff78793
feb784e3
00414503
00510413
00050a63
f65ff0ef
00140413
fff44503
fe051ae3
00000513
01c12083
01812403
01412483
01012903
02010113
00008067
06054063
0605c663
00058613
00050593
fff00513
02060c63
00100693
00b67a63
00c05863
00161613
00169693
feb66ae3
00000513
00c5e663
40c585b3
00d56533
0016d693
00165613
fe0696e3
00008067
00008293
fb5ff0ef
00058513
00028067
40a00533
00b04863
40b005b3
f9dff06f
40b005b3
00008293
f91ff0ef
40a00533
00028067
00008293
0005ca63
00054c63
f79ff0ef
00058513
00028067
40b005b3
fe0558e3
40a00533
f61ff0ef
40b00533
00028067
00000000
00000000
00000000
00000000
00000000
00000000
00000000
00000000
00000000
00000000
00000000
00000000
00000000
00000000
00000000
00000000
00000000
00000000
00000000
00000000
00000000
00000000
00000000
00000000
00000000
00000000
00000000
00000000
00000000
00000000
00000000
00000000
00000000
00000000
00000000
00000000
00000000
00000000
0000fff0
00000010
0000003c
