00010117
ffc10113
008000ef
0000006f
ff010113
00112623
00812423
01010413
39c000ef
00000013
00c12083
00812403
01010113
00008067
000107b7
00a7a223
0047a783
40f50533
00153513
00008067
fd010113
01712623
02112623
00058b93
02812423
02912223
03212023
01312e23
01412c23
01512a23
01612823
01000593
2175e263
00050413
00070493
00078a13
00000a93
1c054c63
06100913
1a061c63
00048b13
00900993
ff690913
000b8593
00040513
2a4000ef
00050713
0ff77693
03068793
000b8593
00040513
012686b3
16e9e663
00fb0023
238000ef
00050413
001b0b13
fca044e3
409b0733
0f477263
fffa0693
416007b3
40e686b3
00500613
40ea0533
0037f793
18d67863
18078063
03000693
00db0023
00100613
001b0593
00170893
02c78263
00db00a3
00200613
002b0593
00270893
00c78863
003b0593
00db0123
00370893
40f50833
ffc80693
0026d693
30303637
00168693
00fb07b3
00000713
03060613
00c7a023
00170713
00478793
fed76ae3
00269693
00d587b3
00d88733
04d80463
03000693
00d78023
00170613
03467c63
00d780a3
00270613
03467663
00d78123
00370613
03467063
00d781a3
00470613
01467a63
00d78223
00570713
01477463
00d782a3
00ab0b33
080a9663
409b0533
000b0023
00155593
02058863
fff50793
00048713
00f487b3
00b485b3
0007c603
00074683
00170713
fff78793
fec70fa3
00d780a3
feb714e3
02c12083
02812403
02412483
02012903
01c12983
01812a03
01412a83
01012b03
00c12b83
03010113
00008067
00db0023
0d0000ef
00050413
001b0b13
e6a040e3
e99ff06f
04100913
e49ff06f
02d00793
00fb0023
001b0b13
f6dff06f
e20696e3
40a00433
00100a93
06100913
e20602e3
fd5ff06f
00000513
f89ff06f
00070893
000b0593
eb5ff06f
000b0793
eedff06f
00054703
04070463
00150693
00100613
000105b7
00e5a223
0045a783
00168693
40f707b3
fff6c703
0017b793
00c7f633
00060793
fe0710e3
0005a223
0045a503
00153513
00f57533
00008067
000105b7
0005a223
0045a503
00100793
00153513
00f57533
00008067
06054063
0605c663
00058613
00050593
fff00513
02060c63
00100693
00b67a63
00c05863
00161613
00169693
feb66ae3
00000513
00c5e663
40c585b3
00d56533
0016d693
00165613
fe0696e3
00008067
00008293
fb5ff0ef
00058513
00028067
40a00533
00b04863
40b005b3
f9dff06f
40b005b3
00008293
f91ff0ef
40a00533
00028067
00008293
0005ca63
00054c63
f79ff0ef
00058513
00028067
40b005b3
fe0558e3
40a00533
f61ff0ef
40b00533
00028067
46c00793
0007a583
0047a603
0087a683
00c7a703
0107c783
fc010113
01010513
02112e23
00b12823
00c12a23
00d12c23
00e12e23
02f10023
020100a3
02010123
020101a3
02010223
020102a3
02010323
020103a3
02010423
020104a3
02010523
020105a3
02010623
020106a3
e79ff0ef
00010537
00410713
00000793
00000693
00000613
00a00593
ffc50513
c09ff0ef
00410513
e51ff0ef
03c12083
00000513
04010113
00008067
