20020005
2003000C
2067FFF7
00E22025
00642824
00A42820
10A7000B
0064202A
10800001
20050000
00E2202A
00853820
00E23822
AC670044
8C020050
08000012
00000000
20020001
AC020054
