20020005
2003000A
00622020
00622822
00433022
00623824
00000000
00624025
0043482A
0062502A
AC020050
AC030054
AC040058
AC05005C
AC060060
AC070064
AC080068
AC09006C
AC0A0070
8C0B0050
8C0C006C
00000000
00000000
016C6820
AC0D0074
