ff010113
00112623
00812423
01010413
00010137
fd010113
044000ef
018000ef
00000013
00c12083
00812403
01010113
00008067
ff010113
00812623
01010413
0000006f
000107b7
fea7ae23
ffc7a783
40a78533
00153513
00008067
0fc00793
0087a683
00c7a703
0007a583
0047a603
0107c783
fe010113
00d12423
00e12623
00f10823
00b12023
00c12223
000108a3
00010923
000109a3
00010a23
00010aa3
00010b23
00010ba3
00010c23
00010ca3
00010d23
00010da3
00010e23
00010ea3
00110693
04800713
000107b7
fee7ae23
0006c703
ffc7a603
00168693
ffc78613
fe0716e3
000107b7
ff078793
00f62023
00000513
02010113
00008067
6c6c6548
6f57206f
20646c72
0a20293b
00000000
00000000
00000000
00000000
00000000
00000000
00000000
00000000
00000000
00000000
00000000
00000000
00000000
00000000
00000000
00000000
00000000
00000000
00000000
00000000
00000000
00000000
00000000
00000000
00000000
00000000
00000000
00000000
00000000
00000000
00000000
00000000
00000000
00000000
00000000
00000000
00000000
0000fff0
00000000
00000034
