00010117
fe010113
010000ef
0000006f
00b52023
00008067
0b800793
0007a703
0047d683
fe010113
0ff77793
00011923
00e12623
00d11823
00011a23
00011b23
00011c23
00011d23
00011e23
00011f23
02078063
000016b7
00d10713
fa068693
00f6a023
00170713
fff74783
fe079ae3
00000513
02010113
00008067
00000000
00000000
00000000
00000000
00000000
00000000
00000000
00000000
00000000
00000000
00000000
00000000
00000000
00000000
00000000
6c6c6548
0000006f
00000000
00000000
00000000
