6c6c6548
6f57206f
20646c72
0a20293b
00000000
00000000
00000000
00000000
00000480
00000430
00000430
00000430
00000430
00000430
00000430
00000430
00000430
00000430
00000430
000004c4
00000438
00000430
00000430
00000430
00000430
00000430
00000430
00000430
00000430
00000430
00000430
00000430
00000430
00000430
00000430
000004d4
00000430
00000438
00000430
00000430
00000480
