6c6c6548
6f57206f
20646c72
0a20293b
00000000
00000000
00000000
00000000
000007c0
00000778
00000778
00000778
00000778
00000778
00000778
00000778
00000778
00000778
00000778
00000868
00000780
00000778
00000800
00000778
00000778
00000778
00000778
00000778
00000778
00000778
00000778
00000778
00000778
00000778
00000778
00000820
00000778
00000780
00000778
00000778
000007c0
00000c38
00000c38
00000c5c
00000c30
00000c30
00000cc4
00000c5c
00000c30
00000cc4
00000c30
00000c5c
00000c2c
00000c2c
00000c2c
00000cc4
02020100
03030303
04040404
04040404
05050505
05050505
05050505
05050505
06060606
06060606
06060606
06060606
06060606
06060606
06060606
06060606
07070707
07070707
07070707
07070707
07070707
07070707
07070707
07070707
07070707
07070707
07070707
07070707
07070707
07070707
07070707
07070707
08080808
08080808
08080808
08080808
08080808
08080808
08080808
08080808
08080808
08080808
08080808
08080808
08080808
08080808
08080808
08080808
08080808
08080808
08080808
08080808
08080808
08080808
08080808
08080808
08080808
08080808
08080808
08080808
08080808
08080808
08080808
08080808
